
NO               o   cub3d-tester/textures/wall.xpm
SO    cub3d-tester/textures/bricks.xpm
WE cub3d-tester/textures/gold.xpm
EA      cub3d-tester/textures/wood.xpm
F   255 ,220,111                  
C   225,      125 , 199                      

 1111111111111111111111
10000000000S000000000001
 1000000000010000000001
  10000000000000000001
   100000000000000001
    1000000010000001
     10000000000001
      100000000001
       1000000001
        10000001
         100001
          1001
           11