NO  ./images/img1..xpm
SO  ./images/img2..xpm
WE  ./images/img3..xpm
    
EA  ./images/img4..xpm
F   000,0128,00                  
C   255, 000, 255

1111111111111111111111
1000000000000000000001
1001110100000000100001
1011000N00111111111111
1010000100000000000001
1001000100000000000001
1000100100000000000001
1001000100000000000001
1010000100000000000001
1000000100011111111111
1000000100000000000001
1000000100000000000001
1000000000000000000001
1000000011000000000001
1000000010000000000001
1001010000000000000001
1101000010000000000001
1000100010000000000001
1010100000000000000001
1100100000000000000001
1111111111111111111111